Ese	Ese,ESe,Esi,ESi
esE	esE,eSE,esI,eSI
ake	ake,aki
akE	akE,akI
aki	aki,ake
akI	akI,akE
ase	ase,aSe,asi,aSi
asE	asE,aSE,asI,aSI
Eki	Eki,Eke
ekI	ekI,ekE
Ike	Ike,Iki
ikE	ikE,ikI
Isi	Isi,ISi,Ise,ISe
isI	isI,iSI,isE,iSE
asi	asi,aSi,ase,aSe
asI	asI,aSI,asE,aSE
ise	ise,iSe,isi,iSi
IsE	IsE,ISE,IsI,ISI
Ise	Ise,ISe,Isi,ISi
isE	isE,iSE,isI,iSI
ESE	ESE,ESI
eSE	eSE,eSI
aSe	aSe,aSi
aSE	aSE,aSI
ISi	ISi,ISe
iSI	iSI,iSE
aSi	aSi,aSe
aSI	aSI,aSE
iSe	iSe,iSi
ESe	ESe,ESi
Esi	Esi,ESi,Ese,ESe
ESi	ESi,ESe
esI	esI,eSI,esE,eSE
eSI	eSI,eSE
Eke	Eke,Eki
ekE	ekE,ekI
Iki	Iki,Ike
ikI	ikI,ikE
isi	isi,iSi,ise,iSe
iSi	iSi,iSe
IsI	IsI,ISI,IsE,ISE
ISI	ISI,ISE
ESI	ESI,ESE
eSI	eSI,eSE
iSi	iSi,iSe
ISI	ISI,ISE
ISE	ISE,ISI
iSE	iSE,iSI
ISe	ISe,ISi
esi	esi,eSi,ese,eSe
EsI	EsI,ESI,EsE,ESE
Ese	Ese,ESe,Esi,ESi
eSi	eSi,eSe
ese	ese,eSe,esi,eSi
eSe	eSe,eSi
EsE	EsE,ESE,EsI,ESI